6
250 0 0
250 250 250
0 250 0
0 0 250
250 250 0
102 0 153
10 16
0 0 0 0 0 0 0 0 0 0 0 0 0 0 0 0
1 1 1 1 0 0 1 1 1 0 0 1 1 1 1 1
0 1 1 1 1 1 1 1 1 1 1 1 1 0 1 0
0 1 1 1 0 1 1 1 1 1 1 1 1 1 1 0
0 0 1 0 0 0 1 1 0 1 1 1 1 0 1 1
0 1 1 1 0 0 0 1 1 1 1 1 1 0 1 0
0 1 1 1 1 1 1 1 0 1 0 0 1 0 0 0
0 0 1 1 0 1 1 1 1 0 0 1 1 1 0 0
0 0 1 0 0 0 1 1 1 0 0 1 1 1 0 0
0 0 0 0 0 0 0 1 0 0 0 0 1 0 0 0
6

250 100 100
200 200 200
100 250 100
100 100 250
250 250 100
102 50 153
0 0 0 0 0 0 0 0 0 0 0 0 0 0 0 0
2 2 2 2 0 0 6 6 6 0 0 1 1 1 1 1
0 2 2 2 2 6 6 6 6 1 1 1 1 0 1 0
0 2 2 2 0 6 6 6 6 1 1 1 1 1 1 0
0 0 2 0 0 0 6 6 0 5 1 1 4 0 1 1
0 3 3 3 0 0 0 5 5 5 1 4 4 0 1 0
0 3 3 3 3 5 5 5 0 1 0 0 4 0 0 0
0 0 3 3 0 5 5 5 5 0 0 4 4 4 0 0
0 0 3 0 0 0 5 5 5 0 0 4 4 4 0 0
0 0 0 0 0 0 0 5 0 0 0 0 4 0 0 0